XXXXXXXXXXXXXXXXXXXXXXXXXXXXXXXXXXXXXXXXXXXXXXXXXXXXXXXXXXXXXXXXXXXXXXXXXXXXXXXXXXXXXXXXXXXXXXXXXXXXXXXXXXXXXXXXXXXXXXXXX
X_s_s_s_s_s_s_s_s_s_s_s_s_s_s_s_s_s_s_s_s_s_s_s_s_s_s_s_s_s_s_s_s_s_s_s_s_s_s_s_s_s_s_s_s_s_s_s_s_s_s_s_s_s_s_s_s_s_s_ssX
X_s_s_s_s_s_s_s_s_s_s_s_s_s_s_s_s_s_s_s_s_s_s_s_s_s_s_s_s_s_s_s_s_s_s_s_s_s_s_s_s_s_s_s_s_s_s_s_s_s_s_s_s_s_s_s_s_s_s_ssX
X_s_s_s_s_s_s_s_s_s_s_s_s_s_s_s_s_s_s_s_s_s_s_s_s_s_s_s_s_s_s_s_s_s_s_s_s_s_s_s_s_s_s_s_s_s_s_s_s_s_s_s_s_s_s_s_s_s_s_ssX
X_s_s_s_s_s_s_s_s_s_s_s_s_s_s_s_s_s_s_s_s_s_s_s_s_s_s_s_s_s_s_s_s_s_s_s_s_s_s_s_s_s_s_s_s_s_s_s_s_s_s_s_s_s_s_s_s_s_s_ssX
X_s_s_s_s_s_s_s_s_s_s_s_s_s_s_s_s_s_s_s_s_s_s_s_s_s_s_s_s_s_s_s_s_s_s_s_s_s_s_s_s_s_s_s_s_s_s_s_s_s_s_s_s_s_s_s_s_s_s_ssX
X_s_s_s_s_s_s_s_s_s_s_s_s_s_s_s_s_s_s_s_s_s_s_s_s_s_s_s_s_s_s_s_s_s_s_s_s_s_s_s_s_s_s_s_s_s_s_s_s_s_s_s_s_s_s_s_s_s_s_ssX
X_s_s_s_s_s_s_s_s_s_s_s_s_s_s_s_s_s_s_s_s_s_s_s_s_s_s_s_s_s_s_s_s_s_s_s_s_s_s_s_s_s_s_s_s_s_s_s_s_s_s_s_s_s_s_s_s_s_s_ssX
X_s_s_s_s_s_s_s_s_s_s_s_s_s_s_s_s_s_s_s_s_s_s_s_s_s_s_s_s_s_s_s_s_s_s_s_s_s_s_s_s_s_s_s_s_s_s_s_s_s_s_s_s_s_s_s_s_s_s_ssX
X_s_s_s_s_s_s_s_s_s_s_s_s_s_s_s_s_s_s_s_s_s_s_s_s_s_s_s_s_s_s_s_s_s_s_s_s_s_s_s_s_s_s_s_s_s_s_s_s_s_s_s_s_s_s_s_s_s_s_ssX
X_s_s_s_s_s_s_s_s_s_s_s_s_s_s_s_s_s_s_s_s_s_s_s_s_s_s_s_s_s_s_s_s_s_s_s_s_s_s_s_s_s_s_s_s_s_s_s_s_s_s_s_s_s_s_s_s_s_s_ssX
X_s_s_s_s_s_s_s_s_s_s_s_s_s_s_s_s_s_s_s_s_s_s_s_s_s_s_s_s_s_s_s_s_s_s_s_s_s_s_s_s_s_s_s_s_s_s_s_s_s_s_s_s_s_s_s_s_s_s_ssX
X_s_s_s_s_s_s_s_s_s_s_s_s_s_s_s_s_s_s_s_s_s_s_s_s_s_s_s_s_s_s_s_s_s_s_s_s_s_s_s_s_s_s_s_s_s_s_s_s_s_s_s_s_s_s_s_s_s_s_ssX
X_s_s_s_s_s_s_s_s_s_s_s_s_s_s_s_s_s_s_s_s_s_s_s_s_s_s_s_s_s_s_s_s_s_s_s_s_s_s_s_s_s_s_s_s_s_s_s_s_s_s_s_s_s_s_s_s_s_s_ssX
X_s_s_s_s_s_s_s_s_s_s_s_s_s_s_s_s_s_s_s_s_s_s_s_s_s_s_s_s_s_s_s_s_s_s_s_s_s_s_s_s_s_s_s_s_s_s_s_s_s_s_s_s_s_s_s_s_s_s_ssX
X_s_s_s_s_s_s_s_s_s_s_s_s_s_s_s_s_s_s_s_s_s_s_s_s_s_s_s_s_s_s_s_s_s_s_s_s_s_s_s_s_s_s_s_s_s_s_s_s_s_s_s_s_s_s_s_s_s_s_ssX
X_s_s_s_s_s_s_s_s_s_s_s_s_s_s_s_s_s_s_s_s_s_s_s_s_s_s_s_s_s_s_s_s_s_s_s_s_s_s_s_s_s_s_s_s_s_s_s_s_s_s_s_s_s_s_s_s_s_s_ssX
X_s_s_s_s_s_s_s_s_s_s_s_s_s_s_s_s_s_s_s_s_s_s_s_s_s_s_s_s_s_s_s_s_s_s_s_s_s_s_s_s_s_s_s_s_s_s_s_s_s_s_s_s_s_s_s_s_s_s_ssX
X_s_s_s_s_s_s_s_s_s_s_s_s_s_s_s_s_s_s_s_s_s_s_s_s_s_s_s_s_s_s_s_s_s_s_s_s_s_s_s_s_s_s_s_s_s_s_s_s_s_s_s_s_s_s_s_s_s_s_ssX
X_s_s_s_s_s_s_s_s_s_s_s_s_s_s_s_s_s_s_s_s_s_s_s_s_s_s_s_s_s_s_s_s_s_s_s_s_s_s_s_s_s_s_s_s_s_s_s_s_s_s_s_s_s_s_s_s_s_s_ssX
X_s_s_s_s_s_s_s_s_s_s_s_s_s_s_s_s_s_s_s_s_s_s_s_s_s_s_s_s_s_s_s_s_s_s_s_s_s_s_s_s_s_s_s_s_s_s_s_s_s_s_s_s_s_s_s_s_s_s_ssX
X_s_s_s_s_s_s_s_s_s_s_s_s_s_s_s_s_s_s_s_s_s_s_s_s_s_s_s_s_s_s_s_s_s_s_s_s_s_s_s_s_s_s_s_s_s_s_s_s_s_s_s_s_s_s_s_s_s_s_ssX
X_s_s_s_s_s_s_s_s_s_s_s_s_s_s_s_s_s_s_s_s_s_s_s_s_s_s_s_s_s_s_s_s_s_s_s_s_s_s_s_s_s_s_s_s_s_s_s_s_s_s_s_s_s_s_s_s_s_s_ssX
X_s_s_s_s_s_s_s_s_s_s_s_s_s_s_s_s_s_s_s_s_s_s_s_s_s_s_s_s_s_s_s_s_s_s_s_s_s_s_s_s_s_s_s_s_s_s_s_s_s_s_s_s_s_s_s_s_s_s_ssX
X_s_s_s_s_s_s_s_s_s_s_s_s_s_s_s_s_s_s_s_s_s_s_s_s_s_s_s_s_s_s_s_s_s_s_s_s_s_s_s_s_s_s_s_s_s_s_s_s_s_s_s_s_s_s_s_s_s_s_ssX
X_s_s_s_s_s_s_s_s_s_s_s_s_s_s_s_s_s_s_s_s_s_s_s_s_s_s_s_s_s_s_s_s_s_s_s_s_s_s_s_s_s_s_s_s_s_s_s_s_s_s_s_s_s_s_s_s_s_s_ssX
X_s_s_s_s_s_s_s_s_s_s_s_s_s_s_s_s_s_s_s_s_s_s_s_s_s_s_s_s_s_s_s_s_s_s_s_s_s_s_s_s_s_s_s_s_s_s_s_s_s_s_s_s_s_s_s_s_s_s_ssX
X_______________________________________________________________________________________________________________________X
X_______________________________________________________________________________________________________________________X
X_______________________________________________________________________________________________________________________X
X_______________________________________________________________________________________________________________________X
X_______________________________________________________________________________________________________________________X
X_______________________________________________________________________________________________________________________X
X_______________________________________________________________________________________________________________________X
X_______________________________________________________________________________________________________________________X
X_______________________________________________________________________________________________________________________X
X_______________________________________________________________________________________________________________________X
X_______________________________________________________________________________________________________________________X
X_______________________________________________________________________________________________________________________X
X_______________________________________________________________________________________________________________________X
X_______________________________________________________________________________________________________________________X
X_______________________________________________________________________________________________________________________X
X_______________________________________________________________________________________________________________________X
X_______________________________________________________________________________________________________________________X
X_______________________________________________________________________________________________________________________X
X_______________________________________________________________________________________________________________________X
X_______________________________________________________________________________________________________________________X
X_______________________________________________________________________________________________________________________X
X_______________________________________________________________________________________________________________________X
X_______________________________________________________________________________________________________________________X
X_______________________________________________________________________________________________________________________X
X_______________________________________________________________________________________________________________________X
X_______________________________________________________________________________________________________________________X
X_______________________________________________________________________________________________________________________X
X_______________________________________________________________________________________________________________________X
X_______________________________________________________________________________________________________________________X
X_______________________________________________________________________________________________________________________X
X_______________________________________________________________________________________________________________________X
X_______________________________________________________________________________________________________________________X
XXXXXXXXXXXXXXXXXXXXXXXXXXXXXXXXXXXXXXXXXXXXXXXXXXXXXXXXXXXXXXXXXXXXXXXXXXXXXXXXXXXXXXXXXXXXXXXXXXXXXXXXXXXXXXXXXXXXXXXXX